222222222222222222222222
222222222222222222222222
222222222222222222222222
222222222222222222222222
222222222222222222222222
222222222222222222222222
222222222222222222222222
222222222222222222222222
222222222111111222222222
222222222111111222222222
222222111111111111222222
222222111111111111222222
222222111111111111222222
222222111111111111222222
222222111111111111222222
222222222111111222222222
222222222111111222222222
222222222222222222222222
222222222222222222222222
222222222222222222222222
222222222222222222222222
222222222222222222222222
222222222222222222222222
222222222222222222222222
222222222222222222222222
222222222222222222222222
222222222222222222222222
222222222222222222222222
222222222222222222222222
222222222222222222222222
