111111111111111111111111
111111111111111111111111
111411111111111111111111
111111111111111111111111
111111111111111111111111
111111111111111111111111
111111111111111114111111
111111411111111111111111
111111111111111111111111
111111111111111111111111
111111111111111111111411
111111111111111111111111
111111111111111111111111
111111111111111111111111
111411111111111111111111
112211111111111111112222
112211111111111111112222
222211111113111111112222
222211111111111111112222
222222222222222222112222
222222222222222222112222
222222223222222222222222
222222222222222222222222
222222222222222222222222
222322222222222222222222
222222222222222222222222
222222222222222222232222
222222222222222222222222
222222222223222222222222
222222222222222222222222
