111111111111111111111111
111111111111111111111111
111111111111111111111111
111111111111111111111111
111111111111111111111111
111111111111111111111111
111111111111111111111111
111111111111111111111111
111111111111111111111111
111111111111111111111111
111111111111111111111111
111111111111111111111111
111111111111111111111111
114111111111111111111111
111111111111111111111111
112211111111111111112222
112211111111111111112222
223211111111111111112222
222211111111111111112222
222222222222222222112222
222222222222222222112222
222222222222222222222222
222222222222222222222222
222222222222222222222222
222222222222222222222222
222222222222222222223222
222222222222222222222222
222222222222222222222222
222222222222222222222222
222222222222222222222222
