2222222222222222222222222222222222222222222222222
2223222222222222222222222222232222222222222222222
2222222222222222222222222222222223222222222232222
2222222222222222222222222222222222222222222222222
2222223222222222222222222222222222222222222222222
2222222222222222222222222222222222222222222222222
2222221111111111111111111111111111411111112222222
2222221111111114111111111111111111111111112222222
2222221111141111111111111111111111114111112222222
2222222222222222222222222222222222222222222232222
2222222222222222222222222222222222222222222222222
2222222222232222222222222222232222222322222222222
2222222322222222222222222222222222222222222222222
2222222222222222222222222222222222222222222222222
2222222222222322222222222222322222222222222222222
